Baboon hawk=Baboon hawk
Bracken=Bracken
Flowerman=Flowerman
Spring=Spring
Blob=Blob
Bunker spider=Bunker spider
Circuit bees=Circuit bees
Coil-head=Coil-head
Earth leviathan=Earth leviathan
Eyeless dog=Eyeless dog
Forest Giant=Forest Giant
ForestGiant=ForestGiant
Forest keeper=Forest keeper
Ghost girl=Ghost girl
Girl=Girl
Hoarding bug=Hoarding bug
Hygrodere=Hygrodere
Jeb=Jeb
Jester=Jester
Landmine=Landmine
Manticoil=Manticoil
Nutcracker=Nutcracker
Roaming locusts=Roaming locusts
Snare flea=Snare flea
Puffer=Puffer
Centipede=Centipede
Spore lizard=Spore lizard
Thumper=Thumper
Crawler=Crawler
Turret=Turret
MouthDog=MouthDog
